{
  "grid":[
    [500,500,500,514,504,507,500,500,500,514,504,504,504,507,500,513],
    [501,500,514,504,512,500,513,500,508,504,504,512,510,509,501,500],
    [0,300,300,300,303,500,500,501,200,510,510,501,508,504,511,501],
    [500,501,200,500,301,501,500,302,300,300,300,303,500,505,504,507],
    [500,500,500,506,301,200,500,301,500,200,501,301,500,501,510,500],
    [501,513,500,200,306,300,300,304,500,501,506,301,200,500,302,100],
    [500,500,501,500,301,500,200,500,509,500,500,301,500,500,301,500],
    [500,501,200,500,301,501,500,514,504,507,500,301,501,500,301,501],
    [0,300,300,300,304,500,508,504,504,507,200,301,500,200,301,500],
    [500,501,500,501,500,509,514,504,504,511,500,305,300,300,304,500],
    [500,500,500,509,508,504,504,504,504,504,511,500,501,500,500,500]
  ],
  "life":2,
  "cash":100,
  "rules":[
    {
      "type":"MONSTER_HP",
      "singleValue": 2
    },
    {
      "type":"BAN_TOWER",
      "listValue": [2,3]
    },
    {
      "type":"CASH_FOR_KILL",
      "singleValue": 1.5
    }
  ],
  "waves":[
    {
      "squads":[
        {
          "enemies": [1, 1],
          "delay": 0
        },
        {
          "enemies": [1, 1],
          "delay": 5000
        }
      ],
      "delay": 10000
    },
    {
      "squads":[
        {
          "enemies": [1],
          "delay": 10
        },
        {
          "enemies": [1, 1, 1],
          "delay": 10000
        }
      ],
      "delay": 10000
    }
  ]
}