{
  "grid":[
    [501,500,500,500,525,500,501,500,500,101,501,500,500,500,535,500],
    [500,500,501,500,525,500,500,501,200,301,500,536,501,500,520,520],
    [500,535,527,526,529,535,500,302,300,304,500,500,520,518,516,516],
    [526,526,529,500,500,500,200,301,501,500,500,524,516,516,516,516],
    [500,501,500,501,518,517,500,301,200,535,500,500,522,516,516,516],
    [500,500,200,500,522,519,500,301,500,501,500,500,501,523,522,516],
    [0,300,300,303,500,500,501,301,500,500,536,500,500,536,501,523],
    [500,500,500,301,536,500,200,301,500,200,500,501,500,500,200,500],
    [501,500,200,301,501,200,500,306,300,300,300,300,300,300,300,100],
    [500,501,500,305,300,300,300,304,500,500,501,200,500,500,500,500],
    [500,500,536,500,500,500,501,500,535,500,500,500,501,500,536,500]
  ],
  "life":2,
  "cash":100,
  "rules":[
    {
      "type":"MONSTER_HP",
      "singleValue": 2
    },
    {
      "type":"BAN_TOWER",
      "listValue": [2,3]
    },
    {
      "type":"CASH_FOR_KILL",
      "singleValue": 1.5
    }
  ],
  "waves":[
    {
      "squads":[
        {
          "enemies": [1],
          "delay": 0
        },
        {
          "enemies": [1],
          "delay": 50000
        }
      ],
      "delay": 100
    },
    {
      "squads":[
        {
          "enemies": [1],
          "delay": 10
        },
        {
          "enemies": [1, 1, 1],
          "delay": 10000
        }
      ],
      "delay": 10000
    }
  ]
}