{
  "grid":[
    [500,500,502,500,500,500,500,501,500,500,500,502,500,500,500,501],
    [500,500,501,514,511,500,502,500,200,500,500,500,500,500,502,500],
    [500,509,514,504,504,507,302,300,300,303,500,501,502,500,501,500],
    [508,504,504,504,512,500,301,500,501,301,500,200,500,500,500,500],
    [501,505,512,510,500,501,301,200,500,306,300,300,300,300,300,100],
    [500,500,500,200,500,513,301,500,200,301,200,500,200,500,501,500],
    [536,501,302,300,300,300,308,200,501,306,300,300,300,303,500,500],
    [501,500,301,500,200,500,301,500,501,301,535,500,500,301,500,500],
    [500,200,301,536,500,500,305,300,300,304,500,501,200,301,535,501],
    [500,500,301,500,500,501,535,500,200,501,500,536,500,301,500,500],
    [501,500,1,500,535,527,526,526,526,526,528,500,501,101,500,500]
  ],
  "life":2,
  "cash":100,
  "rules":[
    {
      "type":"MONSTER_HP",
      "singleValue": 2
    },
    {
      "type":"BAN_TOWER",
      "listValue": [2,3]
    },
    {
      "type":"CASH_FOR_KILL",
      "singleValue": 1.5
    }
  ],
  "waves":[
    {
      "squads":[
        {
          "enemies": [1, 1],
          "delay": 0
        },
        {
          "enemies": [1, 1],
          "delay": 5000
        }
      ],
      "delay": 10000
    },
    {
      "squads":[
        {
          "enemies": [1],
          "delay": 10
        },
        {
          "enemies": [1, 1, 1],
          "delay": 10000
        }
      ],
      "delay": 10000
    }
  ]
}