10|2|3|4|1|2|3|4|1|2|3|4|1|2|3|4
20|3|4|1|2|3|4|1|2|3|4|1|2|3|4|1
30|4|1|2|3|4|1|2|3|4|1|2|3|4|1|2
10|2|3|4|1|2|3|4|1|2|3|4|1|2|3|4
20|3|4|1|2|3|4|1|2|3|4|1|2|3|4|1
30|4|1|2|3|4|1|2|3|4|1|2|3|4|1|2
10|2|3|4|1|2|3|4|1|2|3|4|1|2|3|4
20|3|4|1|2|3|4|1|2|3|4|1|2|3|4|1
30|4|1|2|3|4|1|2|3|4|1|2|3|4|1|2
10|2|3|4|1|2|3|4|1|2|3|4|1|2|3|4
20|3|4|1|2|3|4|1|2|3|4|1|2|3|4|1