11|2|3|4|1|2|3|4|1|2|3|4|1|2|3|4
21|3|4|1|2|3|4|1|2|3|4|1|2|3|4|1
31|4|1|2|3|4|1|2|3|4|1|2|3|4|1|2
11|2|3|4|1|2|3|4|1|2|3|4|1|2|3|4
21|3|4|1|2|3|4|1|2|3|4|1|2|3|4|1
31|4|1|2|3|4|1|2|3|4|1|2|3|4|1|2
11|2|3|4|1|2|3|4|1|2|3|4|1|2|3|4
21|3|4|1|2|3|4|1|2|3|4|1|2|3|4|1
31|4|1|2|3|4|1|2|3|4|1|2|3|4|1|2
11|2|3|4|1|2|3|4|1|2|3|4|1|2|3|4
21|3|4|1|2|3|4|1|2|3|4|1|2|3|4|1